00000
0
Lightning
10
20
30

0 1 1 1 1 1 
1 1 1 1 0 0 
0 0 1 1 1 1 
0 0 1 1 1 0 
0 1 1 1 0 0 
0 1 1 0 0 0 

360