00000
0
Circle
10
40
70

0 0 1 1 0 0 
0 1 1 1 1 0 
1 1 1 1 1 1 
1 1 1 1 1 1 
1 1 1 1 1 0 
0 1 1 1 0 0 

120