00016
3
Tick Tock
6
9
12

0 1 1 1 1 0
1 0 1 0 0 1
1 0 1 0 0 1
1 0 1 1 1 1
1 0 0 0 0 1
0 1 1 1 1 0

45