00000
0
Hourglass
5
10
15

1 1 1 1 1 1 
0 1 1 1 1 0 
0 0 1 1 0 0 
0 0 1 1 0 0 
0 1 1 1 1 0 
1 1 1 1 1 1 

120