00000
0
X
10
20
50

0 1 1 1 1 0
1 0 1 1 0 1
1 1 0 0 1 1
1 1 0 0 1 1
1 0 1 1 0 1
0 1 1 1 1 0

120