00000
0
Lightning
10
50
100

0 1 1 1 1 1 
1 1 1 1 0 0 
0 0 1 1 1 1 
0 0 1 1 1 0 
0 1 1 1 0 0 
0 1 1 0 0 0 

360