00000
0
Hourglass
350
675
900

1 1 1 1 1 1 
0 1 1 1 1 0 
0 0 1 1 0 0 
0 0 1 1 0 0 
0 1 1 1 1 0 
1 1 1 1 1 1 

30