00050
2
change
10
40
90

0 0 0 1 1 0 
0 0 0 1 1 0 
0 0 0 1 1 0 
1 1 1 1 1 1 
1 1 1 1 1 0 
1 1 1 1 1 1 

3