00027
1
nine
19
29
39

1 1 1 1 1 1 
1 1 0 0 1 1 
1 1 1 1 1 1 
0 0 0 0 1 1 
1 1 0 0 1 1 
1 1 1 1 1 1 

9