00000
0
Nine
59
79
99

1 1 1 1 1 1
1 1 0 0 1 1
1 1 1 1 1 1
0 0 0 0 1 1
1 1 0 0 1 1
1 1 1 1 1 1

9