00000
0
Nine
19
39
59

1 1 1 1 1 1 
1 1 0 0 1 1 
1 1 1 1 1 1 
0 0 0 0 1 1 
1 1 0 0 1 1 
1 1 1 1 1 1 

9