00008
3
Avian
6
7
8

1 1 1 1 1 1 
1 1 1 1 1 1 
1 1 1 1 1 1 
1 1 1 1 1 1 
1 0 1 0 1 0 
0 0 0 0 0 0 

Q W O O V N 
W I D E E O 
A R E I S C 
E E Y F N H 
N L G P E V 
L A L R R A 

Birds

QUAIL
EAGLE
DOVE
FINCH
RAVEN
OWL
WREN
OSPREY
